{
    note: "shift  to  grab  then  pull",
    layout: [
        [01, 07, 07, 07, 07, 07, 01, 01, 01],
        [05, 01, 01, 01, 02, 07, 01, 01, 01],
        [01, 07, 07, 07, 07, 07, 01, 01, 01],
        [05, 05, 05, 01, 01, 01, 01, 01, 01],
        [07, 07, 07, 07, 07, 01, 00, 00, 00],
        [01, 01, 01, 07, 07, 01, 00, 00, 00],
        [01, 03, 01, 07, 07, 01, 00, 00, 00],
        [01, 01, 01, 07, 07, 01, 00, 00, 00],
        [01, 01, 01, 05, 05, 05, 00, 00, 00],
    ],
}