{
    note: "T  to  restart  level"
    layout: [
        [00, 00, 00, 00, 00, 00, 00, 01, 01, 01, 00, 00, 00, 00, 00, 00, 00],
        [00, 00, 00, 00, 00, 00, 00, 01, 02, 01, 00, 00, 00, 00, 00, 00, 00],
        [00, 00, 00, 00, 00, 00, 00, 01, 01, 01, 00, 00, 00, 00, 00, 00, 00],
        [00, 00, 00, 00, 00, 00, 00, 07, 15, 07, 00, 00, 00, 00, 00, 00, 00],
        [00, 00, 00, 00, 01, 01, 01, 01, 01, 01, 01, 01, 06, 00, 00, 00, 00],
        [01, 01, 01, 07, 01, 01, 01, 01, 01, 01, 01, 01, 01, 07, 01, 01, 01],
        [01, 05, 01, 08, 01, 01, 01, 01, 05, 01, 01, 01, 01, 08, 01, 14, 01],
        [01, 01, 01, 07, 01, 01, 01, 01, 01, 01, 01, 01, 01, 07, 01, 01, 01],
        [00, 00, 00, 00, 06, 01, 01, 01, 01, 01, 01, 01, 01, 00, 00, 00, 00],
        [00, 00, 00, 00, 00, 00, 00, 07, 15, 07, 00, 00, 00, 00, 00, 00, 00],
        [00, 00, 00, 00, 01, 01, 01, 01, 01, 01, 01, 01, 01, 00, 00, 00, 00],
        [00, 00, 00, 00, 01, 14, 01, 01, 01, 01, 01, 03, 01, 00, 00, 00, 00],
        [00, 00, 00, 00, 01, 01, 01, 01, 01, 01, 01, 01, 01, 00, 00, 00, 00]
    ],
    entities: [
        { // left door
            position: [3, 6],
            watching: [
                [12, 8],
            ],
        },
        { // right door
            position: [13, 6],
            watching: [
                [12, 8],
                [4, 4]
            ],
        }
    ]
}